6 11
..........#
..#..###...
.#S.#.F.#..
.#..#...#..
..##..##...
.........##
